{
  "n": 10,
  "m": 10,
  "data": [
    [4, 4, 4, 4, 4, 4, 4, 4, 4, 4],
    [4, 1, 4, 1, 1, 1, 1, 1, 1, 4],
    [4, 1, 4, 1, 4, 4, 4, 4, 4, 4],
    [4, 1, 4, 1, 4, 1, 1, 1, 1, 1],
    [4, 1, 4, 2, 4, 4, 4, 4, 4, 4],
    [4, 1, 4, 2, 2, 2, 2, 2, 2, 4],
    [4, 1, 4, 2, 4, 4, 4, 1, 4, 4],
    [4, 1, 4, 2, 4, 2, 4, 1, 4, 5],
    [4, 1, 4, 2, 4, 2, 4, 1, 5, 5],
    [4, 1, 4, 4, 4, 2, 4, 5, 5, 5]
  ]
}